..............
..............
..............
.#######......
.......@...#..
..............
....#######...
..#...........
..#...........
..#######.....
..............
..............
